moft	most
muft	must
fome	some
fhould	should
thefe	these
fuch	such
thofe	those
firft	first
alfo	also
ftyle	style
fhall	shall
fubject	subject
Thefe	These
fince	since
himfelf	himself
ftrong	strong
fhe	she
lefs	less
againft	against
Englifh	English
feveral	several
whofe	whose
fenfe	sense
ftrength	strength
prefent	present
difcourfe	discourse
fecond	second
fometimes	sometimes
fentence	sentence
neceffary	necessary
laft	last
fimple	simple
fpeaker	speaker
fet	set
beft	best
higheft	highest
compofition	composition
fpeaking	speaking
caufe	cause
ufed	used
ftill	still
exprefs	express
feems	seems
fpecies	species
diftinguifhed	distinguished
ufe	use
ftudy	study
greateft	greatest
ftate	state
refpect	respect
reft	rest
pleafing	pleasing
fublime	sublime
defcription	description
pleafe	please
fubjects	subjects
requifite	requisite
confiderable	considerable
interefting	interesting
juft	just
leaft	least
eafily	easily
reafon	reason
fpeak	speak
vfe	vse
verfe	verse
paffions	passions
confidered	considered
tafte	taste
inftances	instances
fentences	sentences
inftead	instead
fpirit	spirit
paffage	passage
clofe	close
pleafant	pleasant
fhort	short
pleafures	pleasures
inftance	instance
becaufe	because
perfon	person
ftage	stage
meafure	measure
felfe	selfe
pleafure	pleasure
ufeful	useful
diftinction	distinction
circumftances	circumstances
fingle	single
faid	said
wifh	wish
fmall	small
fpeech	speech
expreffion	expression
ftriking	striking
fuited	suited
glaffe	glasse
ftil	stil
perfons	persons
fhow	show
themfelves	themselves
confifts	consists
expreffed	expressed
ftudied	studied
difcover	discover
prefented	presented
fcene	scene
refemblance	resemblance
converfation	conversation
impreffion	impression
ftand	stand
confider	consider
midft	midst
fhal	shal
caft	cast
fecret	secret
eafy	easy
fentiments	sentiments
ourfelves	ourselves
fcenes	scenes
harfh	harsh
expreffes	expresses
itfelf	itself
ferious	serious
defire	desire
Whofe	Whose
ferue	serue
occafions	occasions
likewife	likewise
ftately	stately
courfe	course
VVhofe	VVhose
Tafte	Taste
fuperior	superior
Addifon	Addison
obferve	observe
confequently	consequently
Befide	Beside
oppofed	opposed
raife	raise
obferved	observed
almoft	almost
conftruction	construction
diftinct	distinct
fuppofe	suppose
addrefs	address
paffion	passion
compofitions	compositions
fays	says
hiftorical	historical
defcribe	describe
progrefs	progress
feeme	seeme
confift	consist
fenfible	sensible
loofe	loose
arifes	arises
defign	design
compofed	composed
defcriptions	descriptions
precife	precise
circumftance	circumstance
feparate	separate
fuppofed	supposed
defcriptive	descriptive
paftoral	pastoral
felf	self
occafion	occasion
paft	past
ftands	stands
fifters	sisters
lofe	lose
concife	concise
Paradife	Paradise
effential	essential
exercife	exercise
relifh	relish
extenfive	extensive
feldom	seldom
fource	source
figns	signs
underftood	understood
reafoning	reasoning
poffeffes	possesses
expreffions	expressions
ftrain	strain
fhows	shows
hiftory	history
difcovers	discovers
feen	seen
houfe	house
fure	sure
falfe	false
earneft	earnest
efpecially	especially
obfcure	obscure
faft	fast
verfes	verses
otherwife	otherwise
paufe	pause
elfe	else
fifter	sister
chofen	chosen
univerfally	universally
juftly	justly
majefty	majesty
fplendid	splendid
defcribed	described
concifenefs	conciseness
verfification	versification
rifing	rising
fentiment	sentiment
diftinguifh	distinguish
previoufly	previously
expreffive	expressive
comparifon	comparison
divifion	division
fomething	something
intereft	interest
Gafcoigne	Gascoigne
foeuer	soeuer
filence	silence
phrafe	phrase
paufes	pauses
faw	saw
affiftance	assistance
fufficient	sufficient
clofely	closely
himfelfe	himselfe
Pleafures	Pleasures
fupply	supply
folid	solid
ferve	serve
refpects	respects
difcovered	discovered
purpofe	purpose
Thofe	Those
deferves	deserves
vaft	vast
fublimity	sublimity
clafs	class
afked	asked
raifed	raised
gefture	gesture
refemble	resemble
ftronger	stronger
hiftorian	historian
paffionate	passionate
mufic	music
drefs	dress
caufes	causes
defcribing	describing
contraft	contrast
comparifons	comparisons
Demofthenes	Demosthenes
difplay	display
earlieft	earliest
paffages	passages
fundrie	sundrie
feme	seme
themfelues	themselues
Bycaufe	Bycause
truftie	trustie
flefh	flesh
truft	trust
thoufand	thousand
ftraight	straight
honeft	honest
breft	brest
ftrikes	strikes
mafter	master
deuife	deuise
iuft	iust
ftrange	strange
bycaufe	bycause
longeft	longest
pleafed	pleased
fuffer	suffer
fpeake	speake
fharpe	sharpe
cenfure	censure
feke	seke
feldome	seldome
eafe	ease
fword	sword
fearch	search
foft	soft
priefts	priests
geftures	gestures
Hiftory	History
furnifh	furnish
rifes	rises
poffefs	possess
ftory	story
difcovery	discovery
fenfibility	sensibility
claffes	classes
fimilar	similar
fimplicity	simplicity
fupported	supported
defcribes	describes
fpread	spread
oppofite	opposite
conftructed	constructed
difpofed	disposed
conftitute	constitute
mufical	musical
neceffity	necessity
underftanding	understanding
vifible	visible
fpeaks	speaks
pafs	pass
foon	soon
bufinefs	business
eftablifhed	established
fucceffion	succession
fkill	skill
perfpicuity	perspicuity
expreffing	expressing
queftion	question
conclufion	conclusion
treatife	treatise
Firft	First
fucceed	succeed
fuggefted	suggested
Shakefpeare	Shakespeare
ftrongly	strongly
perfuafive	persuasive
affembly	assembly
characteriftic	characteristic
feries	series
finifhed	finished
vifit	visit
confequence	consequence
abfence	absence
Glaffe	Glasse
chriftal	christal
inftructions	instructions
praife	praise
englifh	english
paffed	passed
meafures	measures
vfed	vsed
fyllables	syllables
firfte	firste
underftand	understand
deuifed	deuised
foone	soone
fhewe	shewe
profeffed	professed
fingular	singular
accufed	accused
fing	sing
luft	lust
fongs	songs
fong	song
fhuld	shuld
fwelling	swelling
Addifon's	Addison's
Odyffey	Odyssey
tranfition	transition
confufed	confused
reprefentations	representations
interefts	interests
difplayed	displayed
compofe	compose
fphere	sphere
obfervations	observations
picturefque	picturesque
abftract	abstract
purfued	pursued
diftant	distant
ftream	stream
reprefentation	representation
feem	seem
expofed	exposed
phrafes	phrases
fignify	signify
intercourfe	intercourse
profe	prose
founds	sounds
precifion	precision
confeffed	confessed
poffeffed	possessed
requifites	requisites
fmoothnefs	smoothness
preferve	preserve
unlefs	unless
oppofition	opposition
ftrict	strict
pofition	position
befide	beside
ftructure	structure
ufually	usually
efcape	escape
fparkling	sparkling
ftrictly	strictly
defigned	designed
diffufe	diffuse
criticifm	criticism
perfuafion	persuasion
fpeakers	speakers
affemblies	assemblies
juftice	justice
expofe	expose
fituations	situations
richnefs	richness
perfonages	personages
epifodes	episodes
tendernefs	tenderness
allufions	allusions
fteele	steele
paffe	passe
fhewes	shewes
fofter	foster
fundry	sundry
fonne	sonne
fcarce	scarce
fets	sets
fung	sung
fhowe	showe
ftraunge	straunge
rehearfe	rehearse
paffing	passing
horfe	horse
fhalt	shalt
coft	cost
difcourfes	discourses
fpace	space
fuche	suche
furely	surely
leffe	lesse
fhut	shut
fixth	sixth
propofition	proposition
amongft	amongst
fmal	smal
worft	worst
defires	desires
percafe	percase
conftant	constant
feemely	seemely
fhew	shew
ftretch	stretch
mifchiefe	mischiefe
fawe	sawe
Muft	Must
afide	aside
ftreight	streight
fhine	shine
fetting	setting
ftroke	stroke
fent	sent
kift	kist
feemes	seemes
fhore	shore
conftantly	constantly
Suppofing	Supposing
fcattered	scattered
Jerufalem	Jerusalem
lafting	lasting
fondnefs	fondness
correfpondence	correspondence
obfervation	observation
infpire	inspire
fuggeft	suggest
profpect	prospect
fources	sources
purpofes	purposes
darknefs	darkness
indiftinct	indistinct
raifing	raising
fhook	shook
fociety	society
diftrefs	distress
utmoft	utmost
confiderably	considerably
celeftial	celestial
reprefented	represented
fulleft	fullest
fuitable	suitable
fhades	shades
fpreads	spreads
anfwer	answer
increafe	increase
correfponding	corresponding
fprightly	sprightly
earneftly	earnestly
correfpond	correspond
prepofitions	prepositions
fon	son
mafculine	masculine
compafs	compass
diftinguifhing	distinguishing
perfpicuous	perspicuous
fupports	supports
poffible	possible
juftify	justify
difagreeable	disagreeable
fpirited	spirited
fuperfluous	superfluous
epiftolary	epistolary
defcend	descend
ftrefs	stress
happinefs	happiness
fmooth	smooth
largeft	largest
unneceffary	unnecessary
prefents	presents
ufing	using
perfonification	personification
boldnefs	boldness
embellifhing	embellishing
illuftrious	illustrious
adverfary	adversary
compofing	composing
illuftration	illustration
infipid	insipid
coolnefs	coolness
ftiff	stiff
profeffion	profession
embellifhment	embellishment
cautioufly	cautiously
difplaying	displaying
Ariftotle	Aristotle
paftorals	pastorals
diverfified	diversified
accomplifhed	accomplished
feventh	seventh
Efquire	Esquire
Epiftle	Epistle
preferved	preserved
fweet	sweet
finging	singing
ftoode	stoode
fubtil	subtil
teftament	testament
purchafe	purchase
fhewde	shewde
trufty	trusty
fkil	skil
lufty	lusty
prifon	prison
mufe	muse
ftop	stop
foule	soule
Mufe	Muse
fway	sway
vouchfafe	vouchsafe
deferts	deserts
feene	seene
fhalbe	shalbe
fhoulde	shoulde
vnleffe	vnlesse
promife	promise
difclofe	disclose
rayfe	rayse
hardeft	hardest
emphafis	emphasis
fillables	sillables
founde	sounde
Alfo	Also
feemeth	seemeth
reafons	reasons
fyllable	syllable
amiffe	amisse
ftande	stande
afwell	aswell
befte	beste
ftaffe	staffe
fomewhat	somewhat
funne	sunne
feeke	seeke
faying	saying
facred	sacred
bufie	busie
prefume	presume
afhamed	ashamed
fcorne	scorne
fteppes	steppes
(whofe	(whose
hafty	hasty
worfe	worse
harmeleffe	harmelesse
fubtile	subtile
perfuaded	persuaded
feemd	seemd
fprings	springs
fcourge	scourge
Peafant	Peasant
Priefts	Priests
fumpteous	sumpteous
fwete	swete
nobleft	noblest
fouldiours	souldiours
prefence	presence
fkilful	skilful
deferue	deserue
Auguftus	Augustus
Moft	Most
ftay	stay
faide	saide
abfent	absent
fpare	spare
(fince	(since
myfelf	myself
fweete	sweete
lothfome	lothsome
fpend	spend
fyftem	system
purfuit	pursuit
fatisfied	satisfied
Pharfalia	Pharsalia
fcience	science
difgraced	disgraced
ftamp	stamp
inftruction	instruction
boifterous	boisterous
grofs	gross
immenfe	immense
afcribed	ascribed
univerfal	universal
affiftance	affistance
interefted	interested
ftep	step
fenfations	sensations
fenfes	senses
anfwered	answered
boundlefs	boundless
noife	noise
unufual	unusual
mafs	mass
greatnefs	greatness
affift	assist
arifing	arising
ftances	stances
fuccefs	success
tranflation	translation
raifes	raises
fhaking	shaking
fpoke	spoke
enthufiafm	enthusiasm
infignificant	insignificant
excefs	excess
exquifitely	exquisitely
tranfport	transport
felection	selection
pleafes	pleases
fufferings	sufferings
fofter	softer
compaffion	compassion
fudden	sudden
fecondary	secondary
ufual	usual
arife	arise
reprefents	represents
feparated	separated
fuppofe	fuppose
fufficiently	sufficiently
ftock	stock
ftudying	studying
neceffarily	necessarily
fuffered	suffered
fpeaker's	speaker's
ftanding	standing
invifible	invisible
fignifies	signifies
fupplied	supplied
arofe	arose
deferve	deserve
tenfes	tenses
fpoken	spoken
affumed	assumed
barrennefs	barrenness
diveft	divest
refts	rests
diverfity	diversity
abfolutely	absolutely
carelefs	careless
Bifhop	Bishop
livelinefs	liveliness
difpofe	dispose
confpicuous	conspicuous
profufion	profusion
illuftrated	illustrated
diftance	distance
inconfiftent	inconsistent
abfurd	absurd
acceffory	accessory
inftantly	instantly
confufion	confusion
philofophical	philosophical
loweft	lowest
perfonifications	personifications
unfuitable	unsuitable
contrafted	contrasted
philofophy	philosophy
digreffions	digressions
ftiffnefs	stiffness
Laftly	Lastly
fucceeded	succeeded
ftudies	studies
perfuade	persuade
ftating	stating
mafterly	masterly
fuit	suit
lofing	losing
correctnefs	correctness
decifion	decision
infpired	inspired
nefs	ness
addreffed	addressed
teft	test
divifions	divisions
fafhionable	fashionable
fituation	situation
illuftrate	illustrate
fwell	swell
inftructive	instructive
chafte	chaste
diftinguifhes	distinguishes
modefty	modesty
Notwithftanding	Notwithstanding
fhepherd	shepherd
fcenery	scenery
licentioufnefs	licentiousness
politenefs	politeness
enterprife	enterprise
perfonage	personage
Vafco	Vasco
cataftrophe	catastrophe
fpectators	spectators
Verfe	Verse
Efq	Esq
praifeworthy	praiseworthy
exifts	exists
doubtlefs	doubtless
perfonal	personal
dafh	dash
fhowres	showres
fodaine	sodaine
prefumde	presumde
glimfeth	glimseth
fatire	satire
defcant	descant
fteade	steade
Glaffemaker	Glassemaker
myfelfe	myselfe
vanifht	vanisht
feeming	seeming
blafe	blase
didft	didst
haft	hast
foolifh	foolish
ftone	stone
fheep	sheep
flender	slender
plafte	plaste
tranfformed	transformed
fufpect	suspect
vnderftood	vnderstood
ftoutly	stoutly
feas	seas
blafts	blasts
fcape	scape
confcience	conscience
fole	sole
requeft	request
Chrift	Christ
difcharge	discharge
difquiet	disquiet
prefcribed	prescribed
prepofterous	preposterous
neuertheleffe	neuerthelesse
aunfwere	aunswere
prayfe	prayse
depreffed	depressed
fignified	signified
fatiffie	satisfie
difcretion	discretion
Latinifts	Latinists
fhorte	shorte
eafie	easie
fmile	smile
anfwere	answere
finifh	finish
mufte	muste
croffe	crosse
feconde	seconde
worthineffe	worthinesse
affured	assured
correfpondent	correspondent
mifpent	mispent
ftriue	striue
fparke	sparke
lightneffe	lightnesse
filent	silent
Gafcoignes	Gascoignes
peereleffe	peerelesse
efteme	esteme
graueft	grauest
fuffyfe	suffyse
fauce	sauce
(percafe	(percase
deferues	deserues
ghofts	ghosts
fpight	spight
efteemed	esteemed
vnderftand	vnderstand
Philofophers	Philosophers
furpaffed	surpassed
pleafde	pleasde
fpring	spring
fhining	shining
miftake	mistake
profperity	prosperity
fkies	skies
aunceftors	auncestors
fobre	sobre
fhape	shape
Reafon	Reason
abufe	abuse
fubtilty	subtilty
fifhe	fishe
Iuftice	Iustice
reftles	restles
fleepe	sleepe
forfight	forsight
fpent	spent
vnfeene	vnseene
exceffe	excesse
ftrife	strife
fpangs	spangs
fhoes	shoes
fervde	servde
fcarcely	scarcely
fmel	smel
braueft	brauest
fene	sene
beafts	beasts
fpoyle	spoyle
fheath	sheath
defpife	despise
(Bycaufe	(Bycause
fteale	steale
compaffe	compasse
fermon	sermon
fteps	steps
ftealing	stealing
vfde	vsde
reafonable	reasonable
tinfel	tinsel
refufe	refuse
fhewed	shewed
finne	sinne
proceffe	processe
magiftrates	magistrates
manfion	mansion
exercifed	exercised
fel	sel
fooner	sooner
ftuffe	stuffe
fheweth	sheweth
fmyling	smyling
Spanifh	Spanish
forrow	sorrow
geffe	gesse
ftring	string
eldeft	eldest
embraft	embrast
fpurre	spurre
lewdneffe	lewdnesse
felly	selly
guiltleffe	guiltlesse
blufh	blush
dreft	drest
weakeft	weakest
fworde	sworde
afhes	ashes
caufed	caused
fonnes	sonnes
fearching	searching
remorfe	remorse
foremoft	foremost
breaft	breast
difdaine	disdaine
excufe	excuse
Némefis	Némesis
fides	sides
fometime	sometime
rafh	rash
fhortly	shortly
ferviceable	serviceable
Antithefis	Antithesis
Precifion	Precision
Progrefs	Progress
fuba	suba
fyftem	fystem
increafes	increases
fuppofes	supposes
nourifh	nourish
decifions	decisions
affertion	assertion
infeparable	inseparable
precifely	precisely
impofed	imposed
beftow	bestow
afcends	ascends
Criticifm	Criticism
conclufions	conclusions
fucceeding	succeeding
ufefulnefs	usefulness
Effay	Essay
felves	selves
ferved	served
profpects	prospects
fenfation	sensation
diftinctly	distinctly
rufhes	rushes
endlefs	endless
wildnefs	wildness
difregarded	disregarded
ftorm	storm
impreflions	impreslions
deftitute	destitute
aftonifhment	astonishment
imprefa	impresa
reprefenting	representing
affem	assem
Ifaiah	Isaiah
fpeed	speed
fhake	shake
defcending	descending
difmal	dismal
forefts	forests
Concifenefs	Conciseness
tranflated	translated
extinguifhed	extinguished
unneceffarily	unnecessarily
ambrofial	ambrosial
divefted	divested
furround	surround
burlefque	burlesque
fmalleft	smallest
ftores	stores
obferving	observing
conftitutes	constitutes
fky	sky
ferenity	serenity
fimpleft	simplest
refpecting	respecting
artift	artist
fquare	square
fhown	shown
fuggefting	suggesting
fpreading	spreading
fwift	swift
difgufting	disgusting
obferves	observes
landfcape	landscape
claffed	classed
myfterious	mysterious
mildnefs	mildness
focial	social
refembling	resembling
curiofity	curiosity
purfue	pursue
ftatue	statue
profecution	prosecution
infpiration	inspiration
fuppofing	supposing
wifhed	wished
Confequently	Consequently
crafh	crash
fymbols	symbols
hifs	hiss
whiftle	whistle
arifen	arisen
lofs	loss
fignificant	significant
accuftomed	accustomed
gefticulating	gesticulating
focieties	societies
ftrongeft	strongest
referved	reserved
Inftead	Instead
prefs	press
Underftanding	Understanding
tranfpofition	transposition
fupreme	supreme
neareft	nearest
laftly	lastly
wifdom	wisdom
Chinefe	Chinese
ftood	stood
fpringing	springing
undiftinguifhed	undistinguished
diftributed	distributed
fex	sex
difadvantage	disadvantage
prepofition	preposition
paffive	passive
tenfe	tense
difadvantages	disadvantages
fyntax	syntax
ftreams	streams
amufing	amusing
felect	select
fufceptible	susceptible
majeftic	majestic
copioufnefs	copiousness
fupporting	supporting
expreffivenefs	expressiveness
Perfpicuity	Perspicuity
ufage	usage
felected	selected
fhocking	shocking
deteft	detest
miftaken	mistaken
fynonymous	synonymous
polytheifm	polytheism
defigns	designs
treafures	treasures
mifplaced	misplaced
fhifting	shifting
conftructing	constructing
difpofing	disposing
parenthefes	parentheses
preferving	preserving
ftrains	strains
grofsly	grossly
refufed	refused
drynefs	dryness
feparation	separation
feparating	separating
inferted	inserted
adverfity	adversity
beftows	bestows
diftribution	distribution
infenfible	insensible
fhot	shot
meafured	measured
fonorous	sonorous
Harfh	Harsh
fuppofes	fupposes
fubftituted	substituted
impreffed	impressed
fhips	ships
minifter	minister
fafety	safety
fciences	sciences
refembles	resembles
folemn	solemn
ftraining	straining
profperous	prosperous
fnow	snow
impoffible	impossible
herfelf	herself
diftracting	distracting
liftening	listening
afcribe	ascribe
addreffing	addressing
difcoveries	discoveries
embellifh	embellish
propofe	propose
defigning	designing
earneftnefs	earnestness
unpleafing	unpleasing
diftinctions	distinctions
diffufenefs	diffuseness
claffics	classics
inconfiderable	inconsiderable
poffeffing	possessing
induftry	industry
effays	essays
neatnefs	neatness
compofer	composer
fplendor	splendor
childifh	childish
fuggefted	fuggested
coldnefs	coldness
feized	seized
acquifition	acquisition
interpofition	interposition
vifion	vision
phrafeology	phraseology
advifes	advises
hiftories	histories
philofopher	philosopher
confifting	consisting
feeks	seeks
addreffes	addresses
defpotic	despotic
fhone	shone
fea	sea
flourifhed	flourished
roufe	rouse
compenfated	compensated
impetuofity	impetuosity
criticife	criticise
fermons	sermons
inftrument	instrument
unjuft	unjust
fpeeches	speeches
fubftance	substance
difcord	discord
Refpect	Respect
diforder	disorder
choofe	choose
prefenting	presenting
dreffed	dressed
leifure	leisure
Diftinctnefs	Distinctness
fupport	support
choofes	chooses
fubje&t	subje&t
characteriftics	characteristics
ftricteft	strictest
reafonings	reasonings
exhauft	exhaust
metaphyfical	metaphysical
bafis	basis
conftituent	constituent
fecure	secure
ftrike	strike
afcertaining	ascertaining
ferves	serves
feeblenefs	feebleness
alliftance	allistance
loudnefs	loudness
cæfural	cæsural
affume	assume
wifhes	wishes
ftudents	students
preferves	preserves
feize	seize
digefted	digested
ftations	stations
inftitutions	institutions
Treatife	Treatise
philofophers	philosophers
converfed	conversed
diftinctnefs	distinctness
polifhed	polished
amufement	amusement
conftitution	constitution
buftle	bustle
rudenefs	rudeness
tranfports	transports
refort	resort
confequences	consequences
fhepherds	shepherds
abufive	abusive
friendfhip	friendship
Armftrong	Armstrong
epiftles	epistles
blefs	bless
grafs	grass
mafterpiece	masterpiece
eftablifhment	establishment
Taffo	Tasso
fupernatural	supernatural
Difcord	Discord
exquifite	exquisite
ftrokes	strokes
Ulyffes	Ulysses
Portuguefe	Portuguese
boaft	boast
Chriftian	Christian
difplays	displays
fpirits	spirits
defcent	descent
profaic	prosaic
tranfactions	transactions
viciffitudes	vicissitudes
Æfchylus	Æschylus
diftreffes	distresses
fexes	sexes
difturbed	disturbed
unfeafonably	unseasonably
bombaft	bombast
notwithftanding	notwithstanding
fprightlinefs	sprightliness
prefa	presa
(ä’fä	(ä’sä
ā'rf	ā'rs
ofo	oso
balflot	balslot
buf'ga	bus'ga
căr'rfage	căr'rsage
còrfal	còrsal
(shärftē	(shärstē
-mon'chauf	-mon'chaus
-matfing	-matsing
sherif	sheris
-trifsive	-trissive
-fì	-sì
få	så
Coʻrf	Coʻrs
feft	fest
d'æif	d'æis
-shäft	-shäst
-tfed	-tsed
(düfkān	(düskān
-cărʻrfage	-cărʻrsage
gräf	gräs
zāf	zās
(jêr'fa'kn	(jêr'sa'kn
-mākfer	-mākser
-börfer	-börser
horfo	horso
fatu	satu
cif'ic	cis'ic
ifzer	iszer
ēfzer	ēszer
knfp'kneel	knsp'kneel
Kyr'f	Kyr's
(lēflā	(lēslā
Mä'fi	Mä'si
man'f	man's
Mărfa	Mărsa
(-rish'f	(-rish's
(měf'is	(měs'is
(můr'f	(můr's
(mūfzx'käl	(mūszx'käl
hifto	histo
Nătch'f	Nătch's
Näfquet	Näsquet
nfo	nso
-lyfing	-lysing
pft	pst
rif'er	ris'er
-tfvness	-tsvness
prof'o	pros'o
Profto	Prosto
(püfzha	(püszha
-tāfting	-tāsting
-culrfb'ald	-culrsb'ald
chisfel	chissel
tif'ic	tis'ic
-nifzer	-niszer
sgräf	sgräs
-singfing	-singsing
mon'f	mon's
-erfror	-ersror
-morfel	-morsel
-spoon'ful	-spoon'sul
-visfaged	-vissaged
-sulfky	-sulsky
Inftruction	Instruction
confideration	consideration
Gafcoigne's	Gascoigne's
idiofyncratic	idiosyncratic
time-Whetftone's	time-Whetstone's
affociates	associates
dramatifts	dramatists
fatirift	satirist
perifhed	perished
reprefentative	representative
publifhed	published
poefy	poesy
fpecimens	specimens
foufed	soused
Woodftock	Woodstock
devifing	devising
fimultaneoufly	simultaneously
fhowers	showers
fhowre	showre
fummer	summer
“Gafcoigne's	“Gascoigne's
Meffenger	Messenger
North-weft	North-west
refounds	resounds
Limehoufe	Limehouse
Cloakleffe	Cloaklesse
horfeback	horseback
wefterne.windes	westerne.windes
glafle	glasle
Whetftone	Whetstone
Gafkoigne	Gaskoigne
Whetftons	Whetstons
enfue	ensue
feeft	seeft
refolu'd	resolu'd
afmuch	asmuch
feaft	feast
eft	est
ruft	rust
vnforft	vnforst
fterue	sterue
afpire	aspire
Befides	Besides
ftrait	strait
brainfick	brainsick
fifh	fish
hafte	haste
fhipt	shipt
difmay	dismay
fowrs	sowrs
ftopt	stopt
(fcot	(scot
perfwade	perswade
fpoiles	spoiles
defert	desert
blaft	blast
woorthieft	woorthiest
nipft	nipst
praifd	praisd
refrefh	refresh
fot	sot
curfe	curse
fhowes	showes
fport	sport
beaft	beast
emprife	emprise
poyfoned	poysoned
fleep	sleep
fcar	scar
Gafkoign	Gaskoign
difpraife	dispraise
deferu'd	deseru'd
fettle	settle
fpoile	spoile
feek	seek
miftrufteth	mistrusteth
mifconftred	misconstred
ftarue	starue
ftriketh	striketh
woorfe	woorse
miflike	mislike
pofte	poste
cruffhing	crusshing
whilft	whilst
greefe	greese
pearfe	pearse
digeft	digest
fweeteft	sweetest
ficknes	sicknes
choife	choise
mifling	misling
fudain	sudain
ftuft	stuft
ftir	stir
plefures	plesures
threfhed	threshed
fwim	swim
fkin	skin
affaults	assaults
forfe	forse
Gafkoignie	Gaskoignie
rougheft	roughest
toothfome	toothsome
mifts	mists
Abafe	Abase
Parfones	Parsones
defart	desart
fhiftles	shiftles
Duft	Dust
fpares	spares
fatteft	fattest
fnare	snare
Vnfure	Vnsure
nurifh	nurish
fhare	share
confumes	consumes
fick	sick
faues	saues
flafh	flash
fporte	sporte
beftowes	bestowes
bleffing	blessing
(forfte	(forste
feruice	seruice
fortes	sortes
Chrifto	Christo
forfes	forses
fting	sting
bequeft	bequest
mak'ft	mak'st
ftrugling	strugling
fweetly	sweetly
fain	sain
coldeft	coldest
forfte	forste
(vfe	(vse
fcratch	scratch
fmight	smight
luftieft	lustiest
iefting	iesting
ftriuing	striuing
Hypocrifie	Hypocrisie
lotheft	lothest
know'ft	know'st
afwel	aswel
ftaine	staine
loffe	lofse
fmarting	smarting
fouth	south
maift	maist
poft	post
frefher	fresher
vnfure	vnsure
infue	insue
ftead	stead
fvveat	svveat
fovyne	sovyne
Gafkoygne	Gaskoygne
deftroy	destroy
fack	sack
flefhly	fleshly
Gafkoygnes	Gaskoygnes
fyveet	syveet
neceffarie	necessarie
fuperfine	superfine
affaye	assaye
Mafter	Master
(neuertheleffe	(neuerthelesse
couerteft	couertest
ftudie	studie
Likewife	Likewise
fticke	sticke
hiftorie	historie
vnpoffible	vnpossible
cuftomes	customes
fuperlatiue	superlatiue
aduife	aduise
fhee	shee
fhadowes	shadowes
iefts	iests
difcouer	discouer
fithence	sithence
fupernaturall	supernaturall
fkilfull	skilfull
fhortneffe	shortnesse
Emphafis	Emphasis
fcholler	scholler
depreffion	depression
fnatched	snatched
carelefnes	carelesnes
expreffe	expresse
fillable	sillable
Treafure	Treasure
feweft	fewest
wrefte	wreste
iuftly	iustly
fcanning	scanning
vnderftanding	vnderstanding
perufe	peruse
vfual	vsual
Englifhman	Englishman
fmell	smell
mufters	musters
thruft	thrust
vnpleafant	vnpleasant
modeftly	modestly
lafte	laste
ftile	stile
allthefe	allthese
afmuche	asmuche
efchew	eschew
leffon	lesson
fearche	searche
fchollers	schollers
rofted	rosted
inufitata	inusitata
wifhe	wishe
englifhe	englishe
Ceafures	Ceasures
Englifhe	Englishe
Subftantiue	Substantiue
reftes	restes
efpie	espie
needeleffe	needelesse
falfer	falser
fhorter	shorter
fuperfineffe	superfineffe
aduifed	aduised
fimplicitie	simplicitie
fhrewde	shrewde
aunfwer	aunswer
feruing	seruing
Muficians	Musicians
fignifieth	signifieth
acroffe	acrosfe
middeft	middest
aunfwereth	aunswereth
Vifh	Vish
fuffife	suffise
tedioufneffe	tediousnesse
commoneft	commonest
acroffe	acrosse
enterprifes	enterprises
mofte	moste
ftaues	staues
fitteft	fittest
efchue	eschue
obfcuritie	obscuritie
ferueth	serueth
compendioufly	compendiously
Pfalmes	Psalmes
bafhefull	bashefull
wifheth	wisheth
goodneffe	goodnesse
ftirreth	stirreth
induftrious	industrious
curtefy	curtesy
vnworthyneffe	vnworthynesse
encreafe	encrease
conftrained	constrained
hoft	host
wantonneffe	wantonnesse
ynderftanding	ynderstanding
ftreaking	streaking
fpared	spared
expulfed	expulsed
delightfulneffe	delightfulnefse
myfery	mysery
Induftrye	Industrye
aduerfytie	aduersytie
corrofyue	corrosyue
rygoroufly	rygorously
idleneffe	idlenesse
ryotoufly	ryotously
furmyfes	surmyses
mifgouerned	misgouerned
confeffe	confefse
fufpected	suspected
difpayre	dispayre
breftes	brestes
eafye	easye
Phylofophy	Phylosophy
confeffe	confesse
fhoulders	shoulders
Induftrie	Industrie
rehearfed	rehearsed
finke	sinke
aduerfaries	aduersaries
induftrie	industrie
carelefneffe	carelesnesse
aduerfities	aduersities
fcriptures	scriptures
fufpects	suspects
ftubbornefle	stubbornefle
vniuftly	vniustly
VValkamftowe	VValkamstowe
profperitie	prosperitie
rafhe	rashe
prefumed	presumed
falfely	falsely
fpeedy	speedy
Lordfhip	Lordship
befeeching	beseeching
abafhed	abashed
rofte	roste
fkild	skild
fhrowde	shrowde
difcrie	discrie
praifing	praising
efteemde	esteemde
Deuifde	Deuisde
rowfing	rowsing
furmounte	surmounte
fupplie	supplie
counterfhape	countershape
fwerued	swerued
oppreft	opprest
fpyteful	spyteful
deferued	deserued
eftate	estate
fage	sage
feekes	seekes
Abufes	Abuses
worthieft	worthiest
ftomackes	stomackes
figne	signe
folempne	solempne
Difcries	Discries
rymeleffe	rymelesse
Gainft	Gainst
affault	assault
fugred	sugred
faddeft	saddest
defpight	despight
beaftes	beastes
fitte	sitte
ftayres	stayres
bicaufe	bicause
difdainde	disdainde
vouchfafte	vouchsafte
rauifhed	rauished
Vouchfafe	Vouchsafe
(Falfe	(False
defervde	deservde
myfteries	mysteries
gracioufly	graciously
Sifter	Sister
gloffe	glosse
fpeeche	speeche
fute	sute
fiftr	sistr
Syfters	Systers
ftemly	stemly
yfoiorned	ysoiorned
inceft	incest
fayde	sayde
rauifht	rauisht
entift	entist
formoft	formost
Leaft	Least
fpeede	speede
Refiraynte	Resiraynte
ftraue	straue
fister	sister
accufing	accusing
fqueaketh	squeaketh
fuckes	suckes
eclypft	eclypst
ftumps	stumps
feeth	seeth
(bycaufe	(bycause
gliftreth	glistreth
figh	sigh
mifgouernment	misgouernment
poffeffe	possesse
peuifhe	peuishe
fpye	spye
fhrewdly	shrewdly
brufde	brusde
fadde	sadde
groffe	grosse
confume	consume
ficophants	sicophants
nyfelfe	nyselfe
craftefmen	craftesmen
guefts	guests
bafhful	bashful
fpends	spends
fpoyles	spoyles
mifdeedes	misdeedes
(Andfuch	(Andsuch
foolifhly	foolishly
poffeft	pofsest
fuppreft	supprest
befeeme	beseeme
lawleffe	lawlesse
vnleffe	vnlefse
Philofopher	Philosopher
treafure	treasure
Difgraced	Disgraced
Pefant	Pesant
fhift	shift
Prieft	Priest
fubiectes	subiectes
gloffe	glofse
fways	sways
pofterity	posterity
glifter	glister
glafing	glasing
fuckling	suckling
florifh	florish
ftirre	stirre
filkes	silkes
fports	sports
gliftering	glistering
ftones	stones
fmacke	smacke
Muficks	Musicks
trafh	trash
Deferues	Deserues
ftake	stake
fportes	sportes
ftoppe	stoppe
fturdie	sturdie
fetteft	settest
ftables	stables
fickeneffe	fickenesse
ftede	stede
toffe	tosse
difh	dish
ftreine	streine
fweeter	sweeter
foundes	soundes
confent	consent
ftockes	stockes
peerleffe	peerlesse
fpanifh	spanish
filuer	siluer
fnares	snares
gliftring	glistring
fpurne	spurne
fpurres	spurres
(vnfeen	(vnseen
cofts	costs
bumbaft	bumbast
hofe	hose
caufeth	causeth
filke	silke
futes	sutes
ferues	serues
punifh	punish
gafing	gasing
Forfoth	Forsoth
banifh	banish
ftayes	stayes
ftaff	staff
goofe	goose
fcepter	scepter
fatherleffe	fatherlesse
Loråfhip	Loråship
felues	selues
afpiring	aspiring
coaft	coast
Chriftal	Christal
fheperds	sheperds
difeafe	disease
fhielde	shielde
fmoke	smoke
fprong	sprong
frofts	frosts
fhold	shold
befides	besides
conftraine	constraine
profefsion	profession
aftray	astray
mufter	muster
difgrast	disgrast
dreadfulneffe	dreadfulnesse
fpie	spie
fcore	score
fnakes	snakes
ftreete	streete
chefts	chests
Vnleffe	Vnlesse
refpecte	respecte
giltleffe	giltlesse
Vliffes	Vlisses
befeene,within	beseene,within
ftocke	stocke
whifpereit	whispereit
Confume	Consume
concupifcence	concupiscence
fouldiour	souldiour
theirfcarres	theirscarres
glaffe	glafse
couetife	couetise
vnplefant	vnplesant
froft	frost
fuffred	suffred
ferued	serued
purfed	pursed
ftore	store
chofe	chose
prouifion	prouision
drunkenneffe	drunkennesse
chaftitie	chastitie
confumde	consumde
difdayned	disdayned
yffewe	yssewe
fplit	split
Ariftomenes	Aristomenes
Iuftinian	Iustinian
Belifarius	Belisarius
fcores	scores
fumme	summe
fleeue	sleeue
ftint	stint
purfe	purse
craftfman	craftsman
fowe	sowe
fweate	sweate
preffed	pressed
fwinke	swinke
[fnort	[snort
ferch	serch
Peafants	Peasants
defgefted	desgested
fpake	spake
flyde	slyde
ftretcht	stretcht
fleepes	sleepes
fofte	softe
vnfene	vnsene
iefted	iested
iffue	issue
himfelfc	himselfc
Commodioufly	Commodiously
careleffe	carelesse
befieged	besieged
fpin	spin
houfes	houses
veftes	vestes
briftle	bristle
(fcarce	(scarce
Phifnomie	Phisnomie
fwine	swine
fumpteoufly	sumpteously
coafts	coasts
filks	silks
mifhaps	mishaps
falt	salt
fardeft	fardest
fchoolmaifterskeepe	schoolmaisterskeepe
toffed	tossed
crimofine	crimosine
corpfe	corpse
fhippes	shippes
(VVherefuch	(VVheresuch
ftatute	statute
royfters	roysters
Recognifance	Recognisance
Bredftreat	Bredstreat
fwarme	swarme
Savrineffe	Savrinesse
difdayning	disdayning
Cofens	Cosens
holyneffe	holynesse
drunkeneffe	drunkenesse
feafning	seasning
Defcended	Descended
garnifhed	garnished
leefe	leese
hypocrifie	hypocrisie
fift	fist
Alehoufes	Alehouses
vfurie	vsurie
abftinence	abstinence
fue	sue
prieftes	priestes
fhilling	shilling
afhamde	ashamde
wafpe	waspe
funburnt	sunburnt
felde	selde
Chriftes	Christes
clofets	closets
fleeps	sleeps
futours	sutours
flaues	slaues
fuffize	suffize
lefe	lese
pnefts	pnests
fcant	scant
eftates	estates
ftewes	stewes
ftinking	stinking
faintifh	saintish
(forfooth	(forsooth
forpafte	forpaste
fpit	spit
ftablifhing	stablishing
fcab	scab
fhep	shep
finnes	sinnes
foules	soules
gofts	gosts
Vniuerfities	Vniuersities
profeffe	professe
durft	durst
Efteme	Esteme
foryourfelues	foryourselues
Bifhops	Bishops
Truft	Trust
pulteffes	pultesses
Sophiftrie	Sophistrie
corofiues	corosiues
vniuerfities	vniuersities
Aftrologie	Astrologie
Phificke	Phisicke
Hiftoriographers	Historiographers
abufde	abusde
Cofmography	Cosmography
Vnmeafurable	Vnmeasurable
Difdaine	Disdaine
ftink	stink
guilefulft	guilefulst
fcowrde	scowrde
forfooth	forsooth
(priefts	(priests
fhipman	shipman
winft	winst
fhauen	shauen
fweat	sweat
cloyfter	cloyster
fowed	sowed
fhod	shod
dreffe	dresse
horfes	horses
ftich	stich
duft	dust
flefhe	fleshe
horfecorfers	horsecorsers
ruftie	rustie
fhipwracke	shipwracke
fhoo	shoo
fal	sal
Paternofter	Paternoster
fmithes	smithes
facks	sacks
fhoomakers	shoomakers
glafie	glasie
furueyours	surueyours
goldfmithes	goldsmithes
vfeth	vseth
fwearing	swearing
efpied	espied
fhippe	shippe
cuftomers	customers
vpholfters	vpholsters
(Tufh	(Tush
hufwiues	huswiues
fhriues	shriues
ftrays	strays
fwere	swere
fticks	sticks
worthleffe	worthlesse
ftranger	stranger
flicke	slicke
difhes	dishes
monfters	monsters
dellicateft	dellicatest
ftony	stony
frifle	frisle
ftalking	stalking
whiftles	whistles
glimfe	glimse
fubtill	subtill
gafde	gasde
Lordfhips	Lordships
(fpeake	(speake
fpied	spied
fayreft	fayrest
helifh	helish
poffeft	posseft
femely	semely
befech	besech
gafed	gased
preferue	preserue
vnfinifhed	vnfinished
Poefies	Poesies
befeche	beseche
abufed	abused
forrowefull	sorrowefull
voutfafe	voutsafe
lordfhip	lordship
obferuing	obseruing
fingeth	singeth
coftly	costly
Tyttimoufe	Tyttimouse
fhryching	shryching
Throftle	Throstle
feedes	seedes
feely	seely
finge	singe
needleffe	needlesse
wefterne	westerne
meffenger	messenger
fchole	schole
fhryche	shryche
fquire	squire
difporte	disporte
fhrowd	shrowd
fings	sings
Difgrace	Disgrace
reforte	resorte
brutifh	brutish
neaft	neast
ftedfast	stedfast
falfhood	falshood
preft	prest
darkefome	darkesome
piteoufly	piteously
vnifone	vnisone
fantafie	fantasie
fobbe	sobbe
hirfelfe	hirselfe
fwelt	swelt
foong	soong
Wifhing	Wishing
vnderftande	vnderstande
paraphrafe	paraphrase
flomber	slomber
Beboft	Bebost
Preft	Prest
glimfed	glimsed
Iuft	Iust
fnaffle	snaffle
trymmef	trymmes
ripeft	ripest
poyfon	poyson
fomtimes	somtimes
coafte	coaste
fpoufe	spouse
defirde	desirde
hoift	hoist
fatiffied	satisfied
feafting	feasting
ambaffade	ambassade
leyfure	leysure
bofome	bosome
feemde	seemde
wickedneffe	wickednesse
wift	wist
gueft	guest
excufde	excusde
fighes	sighes
(leaft	(least
wifht	wisht
withftande	withstande
fhipping	shipping
chaft	chast
feech	seech
fpredde	spredde
bliffe	blisse
cafteth	casteth
kiffe	kisse
fyre	syre
fcathe	scathe
leafure	leasure
fcorn	scorn
fayles	sayles
fhip	ship
fpilte	spilte
fheepecote	sheepecote
difgraft	difgrast
Difcheveld	Discheveld
fcapte	scapte
luf	lus
forie	sorie
distreffe	distresse
fitts	sitts
difpence	dispence
beftowe	bestowe
wurfi	wursi
deareft	dearest
fobbes	sobbes
canft	canst
lofi	losi
Confcience	Conscience
fkornefully	skornefully
fhame	shame
defpratly	despratly
ftertling	stertling
thickeft	thickest
Burft	Burst
ferpents	serpents
ftirres	stirres
corfe	corse
fepulchre	sepulchre
fhepcote	shepcote
fodainly	sodainly
queinteft	queintest
(amongft	(amongst
reftrainde	restrainde
ftonie	stonie
Miferie	Miserie
mifchieues	mischieues
Enforft	Enforst
fhepecote	shepecote
referue	reserue
fale	sale
fteede	steede
witneffe	witnesse
fware	sware
abafht	abasht
Difcouering	Discouering
conftrainte	constrainte
fpende	spende
fweare	sweare
Inftrument	Instrument
fcrat	scrat
ftearne	stearne
ftoute	stoute
cafte	caste
fleeping	sleeping
fende	sende
bruft	brust
refolvde	resolvde
fadly	sadly
boiftroufly	boistrously
difpatcht	dispatcht
ftert	stert
bofom	bosom
difgeft	disgeft
feekft	seekst
ouerfight	ouersight
feafts	feasts
VVofe	VVose
ftaind	staind
affignde	assignde
fekes	sekes
cloifter	cloister
yongeft	yongest
ftinte	stinte
reftraind	restraind
fmarte	smarte
fmoky	smoky
hearft	hearst
Pheafaunt	Pheasaunt
Theyongeft	Theyongest
maifter	maister
ftarts	starts
forrefts	forrests
weft	west
difcorde	discorde
forepaft	forepast
fowre	sowre
tranfformde	transformde
trangreft	trangrest
deferte	deserte
blafphemy	blasphemy
monfter	monster
forfworne	forsworne
mifcheuoufneffe	mischeuousnesse
kildft	kildst
conveydft	conveydst
latynifts	latynists
affalted	assalted
fplene	splene
Conftrainde	Constrainde
rafheft	rashest
Nemefis	Nemesis
fcand	scand
boft	bost
fmelleth	smelleth
Goddeffe	Goddesse
roft	rost
conftrainde	constrainde
fone	sone
fwetely	swetely
curtefie	curtesie
forfaken	forsaken
myftaffe	mystaffe
fhaddowe	shaddowe
heaft	heast
paftime	pastime
fleepy	sleepy
Againft	Against
flippe	slippe
enfues	ensues
fyneft	fynest
difcents	discents
euerlafting	euerlasting
fharper	sharper
fpil	spil
nigheft	nighest
furdeft	furdest
ftray	stray
Metamorphofed	Metamorphosed
Becaufe	Because
ftormes	stormes
finning	sinning
fcoule	scoule
appeafed	appeased
bluftring	blustring
fighing	sighing
soundshifting	soundshisting
tueifljan	tueisljan
ēf	ēs
dictuf	dictus
flli	slli
promisfsse	promisssse
cafite	casite
fingelis	singelis
Effays	Essays
Stylediffufe	Stylediffuse
Apoftrophe	Apostrophe
TafteSublimity	TasteSublimity
Vifion	Vision
Comparifon	Comparison
Criticifm—Genius-Pleafures	Criticism—Genius-Pleasures
Style~Perfpicuity	Style~Perspicuity
Perfonification	Personification
Eloquence—Demofthenes	Eloquence—Demosthenes
Verfification	Versification
Difcourfe	Discourse
Style-fimple	Style-simple
Afemblies	Asemblies
Epiftulary	Epistulary
Philofophical	Philosophical
Divifion	Division
Spanifo	Spaniso
difcerning	discerning
eftablifh	eftablish
impofture	imposture
applaufe	applause
tranfitory	transitory
contefted	contested
prefumption	presumption
polifh	polish
fymptom	symptom
purfuits	pursuits
infenfibility	insensibility
difpofition	disposition
miftakes	mistakes
didiciffe	didicisse
polifh'd	polish'd
foften	soften
peafants	peasants
favages	savages
difrelifh	disrelish
ftupid	stupid
difcordant	discordant
ftatues	statues
aftonishing	astonishing
difproportioned	disproportioned
diforderly	disorderly
fuperiority	superiority
poifefied	poisefied
coarfeft	coarsest
difcernment	discernment
Correctnefs	Correctness
conftituents	constituents
goodnefs	goodness
eftimates	estimates
ftandard	standard
fineft	finest
ftruck	struck
ftandards	standards
fliortlived	sliortlived
teftimony	testimony
eftablifhes	establishes
Ariftotle's	Aristotle's
fcaitered	scaitered
uninftructed	uninstructed
exclufively	exclusively
profeffions	professions
purfus	pursus
ticifm	ticism
inveftigate	investigate
infift	infist
difcern	discern
thinnefs	thinness
pleft	plest
ftudioufly	studiously
panfe	panse
diftinguifhi	distinguishi
vaftnefs	vastness
confolation	consolation
feeing	seeing
fenfa-	fensa-
dimenfion	dimension
petuofity	petuosity
tempeftuous	tempestuous
irrefiftible	irresistible
fpectaa	spectaa
unobfcured	unobscured
Darknefs	Darkness
refide	reside
defcrip	descrip
Obfcurity	Obscurity
fubJimity	subJimity
ftillnefs	stillness
ftars	stars
Choofe	Choose
adjufted	adjusted
fcurity	scurity
Heroifm	Heroism
furpafs	surpass
fymmetry	symmetry
crimfon	crimson
fteel	steel
unfhaken	unshaken
refto	resto
funs	suns
folely	solely
fpheres	spheres
proftrate	prostrate
rofe	rose
felfish	selfish
fnake	snake
affociated	associated
aftonifhing	astonishing
difpofi	disposi
ftarry	starry
concifea	concisea
Compofition	Composition
Unlefs	Unless
fky.”	sky.”
Mofes	Moses
ftraint	straint
pfalm	psalm
fpreadeth	spreadeth
feverally	severally
ftretcheth	stretcheth
tempefts	tempests
ftern	stern
fhores	shores
topmoft	topmost
fhakes	shakes
fwell’d	swell’d
tranfcribe	transcribe
fecrets	secrets
fummits	summits
tranflates	translates
lafts	lasts
profufe	profuse
fanction	sanction
concifenefs	concisenefs
fignal	signal
tenfion	tension
fhaken.”	shaken.”
Lefs	Less
mifty	misty
hofts	hosts
rifen	risen
fheds	sheds
obfcured	obscured
brightnefs	brightness
difaftrous	disastrous
eclipfe	eclipse
cir-cumftances	cir-cumstances
fented	sented
fhewn	shewn
fuperlatively	superlatively
impreflion	impreslion
fhaded	shaded
fhaggy	shaggy
fubfift	subsist
pofturę	posturę
difgufted	disgusted
deferted	deserted
perfonifying	personifying
unfuccefsful	unsuccessful
fhock	shock
feated	seated
debafing	debasing
perverfity	perversity
vifcera	viscera
.circumftance	.circumstance
humoroufly	humorously
ftorms	storms
Bombaft	Bombast
fubtime	subtime
exift	exist
afociations	asociations
Affociation	Association
fignification	signification
difpofitions	dispositions
foothing	soothing
fitnefs	fitness
fwells	swells
fwiftnefs	swiftness
fublime.-	sublime.-
ingenioufly	ingeniously
gracefulnefs	gracefulness
affemblage	assemblage
bufinefs	bufiness
fpectator	spectator
heroifm	heroism
fub-	sub-
generofity	generosity
paffion	pasfion
fpark	spark
occafionally	occasionally
loofer	looser
Pleafure	Pleasure
forter	sorter
impulfe	impulse
fculpture	sculpture
whichfoever	whichsoever
perfon's	person's
encompafs	encompass
tempeft	tempest
likenefs	likeness
impreffious	impressious
pafturage	pasturage
abfolute	absolute
exifted	existed
paflicnate	paslicnate
defolate	desolate
ifland	island
defired	desired
fuppofe	suppofe
reprefent	represent
difcernible	discernible
ferpent	serpent
refeniblance	reseniblance
difufed	disused
procefs	process
fubfifted	subsisted
ceafed	ceased
gefticulations	gesticulations
preffive	pressive
inftituted	instituted
Rofčius	Rosčius
feemed	seemed
Gefture	Gesture
feya	seya
gef	ges
conteft	contest
Rofcius	Roscius
engroffed	engrossed
inftruments	instruments
Clafa	Clasa
lifelefs	lifeless
cafions	casions
gefticulation	gesticulation
relifhed	relished
reftraining	restraining
fenators	senators
furprife	furprise
fcribe	scribe
wafhed	washed
profeffedly	professedly
inftructors	instructors
wafh	wash
filver	silver
Profe	Prose
Ruffian	Russian
Suppofe	Suppose
diftin&ly	distin&ly
moftcommonly	mostcommonly
ftrive	strive
requefts	requests
tranfpofition	transpofition
poffum.”	possum.”
inverfion	inversion
poteftate	potestate
manfuetudinem	mansuetudinem
reverfes	reverses
diftincti	distincti
fymbol	symbol
hoftile	hostile
pofterior	posterior
fizes	sizes
cnnfequently	cnnsequently
varioufly	variously
fim*ple	sim*ple
boafted	boasted
feventy	seventy
tedioufnefs	tediousness
Japanefe	Japanese
Tonquinefe	Tonquinese
infcriptions	inscriptions
ftylus	stylus
Ifaac	Isaac
Legiflator	Legislator
infcription	inscription
demonftration	demonstration
afh	ash
fubftantives	substantives
exactnefs	exactness
Subftantive	Substantive
furrounded	surrounded
effentially	essentially
fubdivided	subdivided
mifunderftood	misunderstood
exprefiions	expresiions
ifte	iste
inafculine“	inasculine“
faxum	saxum
exprefiing	expresiing
undifcovered	undiscovered
diftinct-	distinct-
referve	reserve
declenfion	declension
Declenfion	Declension
plaineft	plainest
declenfions	declensions
fweetnefs	sweetness
reprefentatives	representatives
handfome	handsome
fuftain	sustain
diftinc	distinc
pooreft	poorest
unfinifhed	unfinished
pluf-quamperfect	plus-quamperfect
aorift	aorist
indivifible	indivisible
myfelf.”	myself.”
fubjunctive	subjunctive
expreflion	expreslion
fuperfede	supersede
difcuffion	discussion
propofitions	propositions
refolved	resolved
Prepofitions	Prepositions
..Conqueft	..Conquest
jufto	justo
fuperadded	superadded
happieft	happiest
furpaffes	surpasses
confiders	considers
fenatorial	senatorial
taftes	tastes
ftatelinefs	stateliness
refpective	respective
beftowed	bestowed
efteem	esteem
demonftrate	demonstrate
perufal	perusal
conftructions	constructions
eftablifhed	eftablished
difcriminately	discriminately
brighteft	brightest
obfolete	obsolete
ftriatly	striatly
fuperfluities	superfluities
Scotticifms	Scotticisms
themfeves	themseves
Gallicifms	Gallicisms
incomprehenfible	incomprehensible
fteady	steady
aftonifhed	astonished
Surprifed	Surprised
refifts	resists
furprifed	surprised
difdain	disdain
diflike	dislike
Haughtinefs	Haughtiness
difapprobation	disapprobation
telefcope	telescope
fimply	simply
Clearnefs	Clearness
perfpieuity	perspieuity
clearnefs	clearness
clumfy	clumsy
large“nefs	large“ness
largenefs	largeness
greatnefs,”	greatness,”
“Theifm,”	“Theism,”
theifm	theism
ifm.”	ism.”
afentence	asentence
ifm	ism
interpofed	interposed
Theifm	Theism
atheifm.”	atheism.”
infpection	inspection
nonfenfe	nonsense
kindnefs.”	kindness.”
difpleafe	displease
fafeft	safest
difunited	disunited
reftored	restored
obferv	observ
unfavory	unsavory
favage	savage
needlefs	needless
fea-fifh.”	sea-fish.”
firft,”	first,”
fufficiency.”	sufficiency.”
elfewhere	elsewhere
deferving	deserving
exercifes	exercises
Oppofed	Opposed
excrefcences	excrescences
ufelefs	useless
fhelter	shelter
hardnefs	hardness
difgufts	disgusts
fplitting	splitting
demonftrative	demonstrative
exprefa	expresa
conqueft	conquest
clofer	closer
underftanding.”	understanding.”
fhoull	shoull
fhorteft	shortest
fufpend	suspend
fignificancy	significancy
fhun	shun
unfhapely	unshapely
interfperfe	intersperse
fubfequent	subsequent
Circumftances	Circumstances
converfation.”	conversation.”
fcattering	scattering
“fcatters	“scatters
counfel	counsel
amufe	amuse
confonants	consonants
unfkilfully	unskilfully
afcent	ascent
eafinefs	easiness
confpires	conspires
farcaftically	farcastically
fhoot	shoot
fufficien“cy	sufficien“cy
converfes	converses
retrofpect	retrospect
harmonioufly	harmoniously
preffion	pression
brifker	brisker
affociations	associations
fulnefs	fulness
fedate	sedate
ftamps	stamps
thunder:Obferve	thunder:Observe
whiftling	whistling
Brifk	Brisk
Cæfariem	Cæsariem
Hefperium	Hesperium
ipfa	ipsa
penfive	pensive
deftroyed	destroyed
arifeth	ariseth
apoftrophes	apostrophes
refem	resem
darknefs.”	darkness.”
affifted	assisted
acceffories	accessories
darknefs”	darkness”
corref	corres
poffibly	possibly
Auguftus.”	Augustus.”
flourifhing	flourishing
cxpreffing	cxpressing
niceft	nicest
refting	resting
inftant	instant
as-exepreffed	as-exepressed
Thompfon	Thompson
rifes,”	rises,”
allifted	allisted
fteadily	steadily
embar-raffment	embar-rassment
eaft	east
haufit	hausit
Bloffoms	Blossoms
fhade”	shade”
fhade	shade
sife	sise
increafed	increased
fediment	sediment
fign	sign
fignifi	signifi
confequent	consequent
ftate,”	state,”
fenlable	senlable
or.comparifon	or.comparison
fimile	simile
reftraint	restraint
Dorfet	Dorset
expreflive	expreslive
leafing	leasing
cuftoms	customs
ftubborn	stubborn
tofs	toss
difpleafing	difpleasing
moftp	mostp
illuftrating	illustrating
felfsame	selfsame
miftrefs	mistress
ftream,”	stream,”
groffelt	grosselt
injudicioufly	injudiciously
Oflian	Oslian
purfu“	pursu“
obfcurity	obscurity
abufes	abuses
fpear	spear
drofs	dross
perifh	perish
conftruct	construct
cenfuring	censuring
confiftent	consistent
confule	consule
Shakefpeare's	Shakespeare's
extinguifh	extinguish
caufas	causas
dulofo	duloso
periculofa	periculosa
ftraina	straina
finks	sinks
conftancy	constancy
minif*	minis*
forfake	forsake
fummer's	summer's
ftate.”	state.”
furface	surface
difpleafure	displeasure
difgufto	disgusto
defpair	despair
miferable	miserable
lavifh	lavish
afcertain	ascertain
reftlefs	restless
afcribing	ascribing
humbleft	humblest
difafter	disaster
ufes	uses
perfonified	personified
boldeft	boldest
fubfide	subside
un-lefs	un-less
refpite	respite
vifitation	visitation
perfonify	personify
deceafed	deceased
difguife	disguise
Eloifa	Eloisa
perfonifies	personifies
addreffes	addresfes
feal’d	seal’d
luftre	lustre
Iniftore	Inistore
ghoft	ghost
funbeam	sunbeam
Offian	Ossian
fimilitude	similitude
fpect	spect
fignature	signature
Senfe	Sense
impreffions	impressions
Refemblance	Resemblance
lufcious	luscious
difguftingly	disgustingly
unfteady	unsteady
likeneffes	likenesses
ftrengthen	strengthen
fimilarly	similarly
antithefis	antithesis
advantageoufly	advantageously
uglinefs	ugliness
firmeft	firmest
paffionºate	passionºate
afk	ask
exprefling	expresling
prife	prise
fympathife	fympathise
uninterefted	uninterested
afpectus	aspectus
fepulta	sepulta
infepulios	insepulios
unfeafone	unseafone
fubito	subito
plenteoufly	plenteously
Otherwife	Otherwise
veftra	vestra
difguft	disgust
oppofer	opposer
punifhed	punished
punifh“ments	punish“ments
guiltlefs	guiltless
mifdeeds	misdeeds
deferved	deserved
comprifed	comprised
nurfe	nurse
deteftaoble	detestaoble
occafioned	occasioned
hiftorians	historians
fententious	sententious
pulfe	pulse
imprefion	impresion
ftyles	styles
compreffes	compresses
oufnefs	ousness
afsiftance	assistance
Montefquieu	Montesquieu
Defcription	Description
Difcourfes	Discourses
l'Efprit	l'Esprit
Hiftorical	Historical
fupplying	supplying
Salluft	Sallust
Harfhnefs	Harshness
clofing	closing
fuffisciently	suffisciently
Livelinefs	Liveliness
promifing	promising
philofoph	philosoph
fatisfaction	satisfaction
epiftle	epistle
ftyle.implies	style.implies
drieft	driest
difpleafes	displeases
converfing	conversing
difadvan	disadvan
poffeffed	poffesfed
impofing	imposing
fickly	sickly
Shaftefbury	Shaftesbury
blemifhes	blemishes
bufkins	buskins
allufion	allusion
poffefs	pofsefs
folidity	solidity
fubjeet	subjeet
fullnefs	fullness
clofet	closet
careleffnefs	carelessness
paffions	pasfions
paufing	pausing
expenfe	expense
efcaped	escaped
flowly	slowly
indifpenfably	indispensably
fevere	severe
expreffion	expresfion
tranflating	translating
Defire	Desire
poffeffion	possession
foppifh	foppish
engrofs	engross
infifted	insisted
analyfis	analysis
clofes	closes
ftraitened	straitened
fatiated	satiated
fes	ses
promifcuoufly	promiscuously
Jenfe	Jense
parenthefis	parenthesis
diffufive	diffusive
univerfe	universe
furnifhes	furnishes
landfcapes	landscapes
mifcuoufly	miscuously
fpeculations	speculations
uncircumfcribed	uncircumscribed
ofm-fuch	ofm-such
Neatnefs	Neatness
vifions	visions
tranfporiing	transporiing
confefed	confesed
tranfporting	transporting
converfe	converse
affent	assent
adminifter	administer
refrefhment	refreshment
fatisfa£iion	satisfa£iion
diverfion	diversion
bufic92efs	busic92ess
prefcribe	prescribe
loofely	loosely
difperfe	disperse
fafe	safe
embarrafs	embarrass
difquifitions	disquisitions
fettled	settled
fhowed	showed
perfua	persua
ftable	stable
perfuading	persuading
fincerity	sincerity
oftentation	ostentation
tirefome	tiresome
inftruct	instruct
felecting	selecting
refolve	resolve
reafoni	reasoni
neceffity.of	necessity.of
controverfies	controversies
enthufiafm	enthusiafm
refent	resent
Eaftern	Eastern
infpires	inspires
dif	dis
ftates	states
fucceffively	successively
diftraction	distraction
ftruggled	struggled
practifed	practised
fprung	sprung
accufes	accuses
refources	resources
afleep	asleep
anceftors	ancestors
fhoulder	shoulder
ftudent	student
tranfcribed	transcribed
pleafantry	pleasantry
ftrong>	strong>
auftere	austere
unpolifhed	unpolished
refembled	resembled
accomplifhments	accomplishments
fuccefsful	successful
prepoffeffes	prepossesses
fuggefts	suggests
Hortenfius's	Hortensius's
fhowy	showy
roufed	roused
reftraints	restraints
ftated	stated
defirous	desirous
fervices	services
panegyrift	panegyrist
tranflate	translate
“mofthenes	“mosthenes
confefs	confess
hefitate	hesitate
modeft	modest
ftance	stance
ftrained	strained
fwollen	swollen
fcourged	scourged
harfh-	harsh-
Chriftianity	Christianity
no-bleft	no-blest
minifterial	ministerial
chaftened	chastened
ifecondary	isecondary
fyftem.of	system.of
accomplifhment	accomplishment
Reftoration	Restoration
difadvantagę	disadvantagę
fectaries	sectaries
manlinefs	manliness
efpoufe	espouse
accuftom	accustom
unconftrained	unconstrained
fcope	scope
fervice	service
unifon	unison
paffions	pafsions
calmnefs	calmness
juftified	justified
fenfibilities	sensibilities
adjuft	adjust
difpleafed	displeased
ufelefs	uselefs
ufea	usea
hauft	haust
derftanding	derstanding
fhowing	showing
ftatutes	statutes
chaftifed	chastised
fobergand	sobergand
jurifprudence	jurisprudence
feverity	severity
confifted	consisted
intrufted	intrusted
fuperfeded	superseded
bu-finefs	bu-siness
needlefsly	needlessly
haftily	hastily
Verbofity	Verbosity
practife	practise
adverfe	adverse
difcern-ment	discern-ment
fairnefs	fairness
minutenefs	minuteness
perfonates	personates
proftituting	prostituting
referveing	reserveing
manifeftly	manifestly
injuftice	injustice
femblies	semblies
difcufs	discuss
fenfe	fense
alfo,”	also,”
fev	sev
diminifh	diminish
afpect	aspect
eafieft	easiest
affuming	assuming
pofteffes	posteffes
effay	essay
purfuing	pursuing
affema	assema
philofophiecal	philosophiecal
fubfides	subsides
extinguifhes	extinguishes
Fafhion	Fashion
extenfively	extensively
fervili	servili
indifpenfable	indispensable
prefently	presently
Modefty	Modesty
noftra	nostra
ufque	usque
fubject.is	subject.is
whofoever	whosoever
Bleffed	Blessed
fatisfy	satisfy
dwellinghoufe	dwellinghouse
bleffed	blessed
divifione	divisione
diftinck	distinck
fuperb	superb
fubject:muft	subject:must
difocourfe	disocourse
difcuffed	discussed
ferving	serving
Unneceffary	Unnecessary
cife	cise
fubdivifions	subdivisions
fcripture	scripture
difcourfed	discoursed
oppofing	opposing
difpofition	dispofition
expreffing	exprefsing
circumftantial	circumstantial
inftructįve	instructįve
illuftrations	illustrations
"confpicuous	"conspicuous
diftin&t	distin&t
diftruft	distrust
lofes	loses
Confider	Consider
fatisfactory	satisfactory
fufpicious	suspicious
diminifhes	diminishes
fafer	safer
prefumptive	presumptive
kindnefs	kindness
fettin	settin
fufa	sufa
fuccefsful	fuccessful
difcourfe	difcourse
dilcourfe	dilcourse
obvioufly	obviously
fruftrates	frustrates
fureft	furest
clufion	clusion
difappointing	disappointing
flownefs	slowness
whifper	whisper
fons	sons
fpeak-ing	speak-ing
maffes	masses
perfevering	persevering
offenfive	offensive
affent	afsent
fuppofed	fupposed
flownefs	flowness
induftrioufly	industriously
aflifts	aflists
ftrongeft	strongeft
percuffion	percussion
'inftructions	'instructions
fpeechi	speechi
difa	disa
agrecable-nefs	agrecable-ness
fena	sena
fecondo	secondo
emphafes	emphases
faime	saime
perufing	perusing
Paufes	Pauses
fuffers	suffers
fingfong	singfong
:verfe	:verse
fufpenfion	suspension
facrifice	sacrifice
flighteft	slightest
exprefion	expresion
fentinients	sentinients
unperfuafive	unpersuasive
perfualive	persualive
freeft	freest
pofture	posture
fabject	sabject
niuft	niust
gefticulate	gesticulate
monifhing	monishing
deftruction	destruction
Earneftnefs	Earnestness
unreftrained	unrestrained
afliit	asliit
difmifs	dismiss
diftref	distres
poffeffes	posseffes
illufions	illusions
difad	disad
'ufeful	'useful
guifhed	guished
Induftry	Industry
tinguifh	tinguish
diftin	distin
languifh	languish
flavifh	slavish
deftructive	destructive
deftined	destined
fpoo	spoo
fpokeri	spokeri
Shaftfbury's	Shaftsbury's
feemingly	seemingly
fup	sup
promifcuous	promiscuous
Exercifes	Exercises
flimfy	flimsy
feminaries	seminaries
fophifts	fophists
profoundeft	profoundest
difgrace	disgrace
Dionyfius	Dionysius
confulted	consulted
Halicarnaffus	Halicarnafsus
Almoft	Almost
difpute	dispute
peevilhnefs	peevilhness
fyftems	systems
eftablifhes	eftablishes
fhaken	shaken
difcredit	discredit
eltablifhed	eltablished
extenfion	extension
aftronomy	astronomy
fharpen	sharpen
inftitute	institute
chemiftry	chemistry
claflics	claslics
intenfe	intense
enthufiafm	enthufiasm
ftimulated	stimulated
inftruca	instruca
quaintnefs	quaintness
ambaffadors	ambassadors
difcuffions	discussions
infinuated	insinuated
fmartnefs	smartness
differtation	dissertation
pofts	posts
refult	result
turefque	turesque
folicitous	solicitous
Acutenefs	Acuteness
hif	his
meannefs	meanness
Robertfon	Robertson
refearch	research
luftrates	lustrates
annalift	annalist
tranfaction	transaction
ufefulonefs	usefuloness
fieges	sieges
illuftrates	illustrates
Shaftfbury	Shaftsbury
treatifes	treatises
obfcures	obscures
myftical	mystical
exceffive	excessive
characteriftical	characteristical
ep:ftles	ep:stles
fprightlinefs	fprightliness
Milefian	Milesian
whatfoever	whatsoever
Perfians	Persians
infuf	insuf
courtefy	courtesy
difcontinued	discontinued
fpinning	spinning
Crufoe	Crusoe
Furiofo	Furioso
Britifh	British
difbelieved	disbelieved
Richardfon	Richardson
Interefting	Interesting
Robinfon	Robinson
idlenefs	idleness
immeafurable	immeasurable
difputes	disputes
queftions	questions
effence	essence
mufician	musician
Mufic	Music
comprife	comprise
fcalders	scalders
acutenefs	acuteness
brifkeft	briskest
refted	rested
funfhine	sunshine
fpotlefs	spotless
kifs	kiss
brifk	brisk
fmiles	smiles
fenfibly	sensibly
crofs	cross
refign'd	resign'd
Goddefs	Goddess
affemble	assemble
difencumbered	disencumbered
fmoothed	smoothed
ftanza	stanza
Elyfian	Elysian
affociate	associate
mifery	misery
rofes	roses
diverfify	diversify
particularifed	particularised
fylvis	sylvis
umbrofa	umbrosa
refiding	residing
defpairing	despairing
denfas	densas
miftrefs's	mistress's
couldft	couldst
rofeida	roseida
abftulit	abstulit
difcourfing	discoursing
difentangling	disentangling
Talfo	Talso
fervants	servants
veftèr	vestèr
fucceffes	successes
difaf	disas
pifcatory	piscatory
furprife	surprise
rivalfhip	rivalship
immodeft	immodest
fifher-men	fisher-men
Fifhes	Fishes
defcends	descends
ftruggles	struggles
rufticity	rusticity
fifhermen	fishermen
Ramfay	Ramsay
Gefner	Gesner
pafto	pasto
foftnefs	softness
paftotal	pastotal
Paftor	Pastor
Shenftone's	Shenstone's
obfo	obso
diftinguished	distinguished
ruftic	rustic
Enthufiafm	Enthusiasm
Feftive	Festive
enthufiaftic	enthusiastic
Polifh	Polish
Cafimir	Casimir
Dodfley's	Dodsley's
Mifcellanies	Miscellanies
embellifhes	embellishes
leffons	lessons
Arifteus	Aristeus
embellifhments	embellishments
Deprefo	Depreso
fatirifts	satirists
weakneffes	weaknesses
Akenfide	Akenside
fatires	satires
Eafe	Ease
Perfius	Persius
groffnefs	grofsness
Univerfal	Universal
overftrained	overstrained
Thomfon's	Thomson's
Seafons	Seasons
deferiber	deseriber
richeft	richest
peftilence	pestilence
weaknefs	weakness
ftorehoufe	storehouse
Penferofo	Penferoso
Penferofo	Penseroso
ghaftly	ghastly
beamlefs	beamless
fmoothfhaven	smoothfhaven
fiefhy	fieshy
unfeen	unseen
drowfy	drowsy
thiftle	thistle
whiftled	whistled
Defolate	Desolate
abyfs	abyss
refound«	resound«
mofs	moss
perufed	perused
juftnefs	justness
ftrengthened	strengthened
refpondent	respondent
muficians	musicians
verficle	versicle
femi-chorus	semi-chorus
ifles	isles
falvation	salvation
rifeth	riseth
bloffom	blossom
Conmparifons	Conmparisons
burfting	bursting
wildernefs	wilderness
thirfty	thirsty
Teftament	Testament
eaftern	eastern
cuftom	custom
burft	burst
compofers	composers
paffages	pafsages
Hofea	Hosea
Pfalms	Psalms
characterife	characterise
fents	sents
tranfgreffed	transgressed
infifts	insists
effen	esfen
Boffu	Bossu
fuccefsfully	fuccessfully
fubverfion	fubversion
expulfion	expulsion
terefting	teresting
obftacles	obstacles
depreffes	depresses
fufpenfe	sufpense
feven	seven
auguft	august
difcrimination	discrimination
pa’fed	pa’sed
fuperftition	superstition
fhadows	shadows
comprifing	comprising
Defcriptions	Descriptions
fiege	siege
unfeafonable	unfeasonable
fhedding	shedding
friendfhips	friendships
highfpirited	highspirited
opennefs	openness
notorioufly	notoriously
fingularly	singularly
ftories	stories
difturb	disturb
inftructs	instructs
hofpitality	hospitality
flave	slave
diftruftful	distrustful
fcolding	scolding
corrednefs	corredness
fettlement	settlement
keennefs	keenness
oppofes	opposes
Anchifes	Anchises
finifhing	finishing
Creufa	Creusa
Laufus	Lausus
feffes	fesses
Nifus	Nisus
mafterpieces	masterpieces
fcens	scens
epifode	episode
defceAt	desceAt
Cæfar	Cæsar
digreffive	digressive
confeffedly	confessedly
fubY	subY
difgufting	difgusting
ftoic	stoic
difquifition	disquisition
fhifts	shifts
Chriftendom	Christendom
Chriftians	Christians
Tåffo	Tåsso
folemnities	solemnities
fentimental	sentimental
mfinuating	msinuating
refentful	resentful
interpofe	interpose
ftrictures	strictures
Eaft	East
Lufiad	Lusiad
goddefs	goddess
Mahometanifm	Mahometanism
deftin	destin
difcovering	discovering
fuddenly	suddenly
difappeared	disappeared
Aourifhing	Aourishing
pafe	pase
Calypfo	Calypso
punifhments	punishments
languifhes	languishes
manfions	mansions
myftic	mystic
thufiafm	thusiasm
difcov	discov
maffacres	massacres
fhocks	shocks
exiftence	existence
Ghofts	Ghosts
difpositions	dispositions
inftanee	instanee
bufy	busy
metaphyfician	metaphysician
aftonifhmenta	astonishmenta
refentment	resentment
juftifies	justifies
gentlenefs	gentleness
condefcenfion	condescension
expreffively	expressively
ftupendous	stupendous
grafp	grasp
punifhment	punishment
cleareft	clearest
Thefpis	Thespis
feftival	festival
anfwering	answering
abfurdity	absurdity
leffened	lessened
confpire	conspire
embarraffment	embarrassment
patriotifm	patriotism
expofition	exposition
fufpenfe	fufpense
Paffionate	Passionate
ditrefs	ditress
inftinct	instinct
fufferers	sufferers
diftrefs	diftress
diminifhed	diminished
fympathy	sympathy
ferioas	serioas
clofed	closed
converfations	conversations
profeffes	professes
fhifted	shifted
perfonæ	personæ
fufpending	suspending
fucceffive	successive
fpectacle	spectacle
princeffes	princesses
raif	rais
Defdemona	Desdemona
adminiftration	administration
tranfgreffions	transgressions
fpecta	specta
imprefs	impress
ftudioufly	ftudiously
averfion	aversion
jealoufy	jealousy
affigned	assigned
confeffes	confesses
fwears	swears
fenfibility	fensibility
difappointed	disappointed
byftander	bystander
trefs	tress
hufband	husband
fpurring	spurring
blafted	blasted
Pafe	Pase
ftiffens	stiffens
majeftyy	majestyy
ftrings	strings
conftraint	constraint
Wolfey's	Wolsey's
foliloquy	soliloquy
barbarifms	barbarisms
mafks	masks
inftrumental	instrumental
expofitions	expositions
ftages	stages
difadvantagese	disadvantagese
fhooting	shooting
predeceffors	predecessors
exhaufted	exhausted
grotefque	grotesque
abfurdities	absurdities
Preferved	Preserved
uninterefting	uninteresting
pafficns	passicns
difafters	disasters
Thomfon	Thomson
fatirical	satirical
difcriminate	discriminate
fuccefsfully	successfully
mifchief	mischief
expofes	exposes
difcriminations	discriminations
fom	som
Mere-converfation	Mere-conversation
oppofitions	oppositions
oppofites	opposites
fubordinate	subordinate
fould	sould
Ariftophanes	Aristophanes
unfeafonable	unseasonable
circumftan	circumstan
obfcenity	obscenity
pertnefs	pertness
ferie	serie
'scrrectnefs	'scrrectness
coarfely	coarsely
fcurrility	scurrility
confcious	conscious
chrifcianity	chriscianity
paganifm	paganism
Mifanthrope	Misanthrope
fummit	summit
rifible	risible
Johnfon	Johnson
fingularity	singularity
Falftaff	Falstaff
coarfe	coarse
modern-ftage	modern-stage
Hufband	Husband
obfcu	obscu
pleafurable	pleasurable
cafy	casy
chaftity	chastity
reftoration	restoration
Carelefs	Careless
increafing	increasing
unjuftifiable	unjustifiable
samefthought	samesthought
